0	2	3	7	9999	9999	9999	9999	9999	9999	9999
2	0	9999	9999	5	10	9999	9999	9999	9999	9999
3	9999	0	9999	8	6	15	9999	9999	9999	9999
7	9999	9999	0	9999	4	3	9999	9999	9999	9999
9999	5	8	9999	0	9999	9999	13	9	9999	9999
9999	10	6	4	9999	0	9999	12	16	11	9999
9999	9999	15	3	9999	9999	0	9999	4	14	9999
9999	9999	9999	9999	13	12	9999	0	9999	9999	17
9999	9999	9999	9999	9	16	4	9999	0	9999	21
9999	9999	9999	9999	9999	11	14	9999	9999	0	18
9999	9999	9999	9999	9999	9999	9999	17	21	18	0